A # # # # # # # # # # 
  #       #       #  
  # # # # # # # # #  
  #       #       #  
  # # # # # # # # #  
  #       #       #  
  # # # #   # # # #  
  #       #       #  
  # # # # # # # # #  
  #       #       #  
    # # # # # # # B  