A # # # # # # # # 
  #       #     # 
  # # # # #   # # 
  #   #       # # 
  #   # # # #   # 
  #   #       # # 
  # # # # # #   # 
  #       #   # # 
  # # # # # # B   
        #########