A # # # # # # # # # # 
  #           #       #  
  #   #   #   #   #   #  
  #   #   #       #   #  
  #       #   #   #   #  
  #   #   #   #   #   #  
  #   #           #     #  
  #   #   #   #   #   #  
  #           #   #     #  
  # # # # # # #   B   #  
                         